1111111111111111111dasd111111111
10000000000011110000000000000001
S0111111000000001111111111111111
10111111111111111100000000000011
10000000000000000000000000000011
10000000000000001111111100000011
11100001111111000000000000000011
10000000000000000000000000000011
10111100000000011111111100000011
10011111111101111111111111111011
1000000000000000000000000000000F
11111111111111111111111111111111